########
########
#XXXXX#X
#X#####X
#X#XXXXX
#X######
#XXXXXX#
########